################################
#..............................#
#.........................PP...#
#.........................PP...#
#..............................#
#..............................#
#..............................#
#..............................#
#..............................#
#..............................#
#..............................#
#..............................#
#..............................#
#..............................#
#..P...........................#
#..P...........................#
#..P...........................#
#..P...........................#
#..P...........................#
#..P...........................#
#..............................#
#..............................#
#..............................#
#..............................#
#..............................#
#..............................#
#..............................#
#..............................#
#...........PPPPPPPPPPP........#
#..............................#
#..............................#
################################
